6 22
    +-+---+---+   +---+---+
    |.|...|...|   |...|...|
    |.|.|.|.|.+---+.|.|.|.|
    |...|...|.......|...|.|
    +---+---+.+-+.--+---+-+
    |.........| |.........|
    +---------+ +---------+