8 23
   +---------+---+---+-------------------+
   |.........|...|...|...................|
   |.|.----+.|.|.|.|.|.+---------------+.|
   |.|.....|.|.|.|.|.|.|...............|.|
  ++-+--.|.|.|.|.|.|.|.+---+.+-------+.|.|
  |......|.|...|...|.|.....|.|.......|.|.|
  ++-----+.+---+---+.+.----+.|.----+.+-+.|
   |.....|.....|...|.........|.....|.....|
   |.+--.+----.|.|.|.|.+-+---+---+.+-----++
   |.|.........|.|.|.|.|.|...|...|.|......|
   |.|.+-------+.|.|.|.|.|.|.|.|.|.|.--+-++
   |.|...........|...|.|.|.|.|.|.|.....|.|
   |.+-----------+---+.|.|.|.|.|.+----.|.|
   |...................|...|...|.........|
   +-------------------+---+---+---------+